21 21
9 10
##########.##########
..#...........#.....#
#.#.#########.#.###.#
#...#.........#.#...#
###############.#.###
#.....#.......#.#...#
#.#######.###.#.#.#.#
#...#...#...#...#.#..
###.###.###.###.#.#.#
#.#.#.#...#.#...#.#.#
#.#.#.#.#.#.#.###.#.#
#...#.#.#.#.#...#.#.#
#####.###.#.#####.###
#.#.......#.#...#...#
#.#.#######.#.#.###.#
#.#.#...#...#.#.#...#
#.#.###.#.#####.#####
#.#.................#
#.#######.#########.#
#.........#..........
####.######.#########
